Solo Set
Against the Wind - Bob Seger
AKA... Broken Arrow - Noel Gallagher
Babylon - David Gray
Boys of Summer - Don Henley / Ataris
Crash - Dave Matthews Band
Don't Stop Believing - Journey
Everything You Want - Vertical Horizon
Free - Train
Friends in Low Places - Garth Brooks
Good Riddance - Green Day
Hotel California - The Eagles
I Am - Train
If You Could Only See - Tonic
Jumper - Third Eye Blind
Little Black Submarines - Black Keys
Norwegian Wood - The Beatles
Nights in White Satin - Moody Blues
Old Man - Neil Young
Plush acoustic - Stone Temple Pilots
Simple Man - Shinedown
Somebody to Love - Jefferson Airplane
Take it Easy - The Eagles
Thunder Road - Bruce Springsteen
Times Like These (acoustic) - Foo Fighters
Wonderwall - Oasis
Wanted Dead or Alive - Bon Jovi
Vienna - Billy Joel
You've Got to Hide Your Love - The Beatles
You and Me - Lifehouse
The Weight - The Band
